111111111111111111111
1000P0001111111111111
10E000C00000000P00001
111111111111111111111
